851004

Уважаемые студенты! У вас карантин с 8 февраля по 8 марта 2021 г. Чтобы вы за это время не умерли со скуки, предлагаю Вам написать реферат по экономической теории. Далее приводится список вашей группы и номер темы реферата, который вы должны написать. Названия рефератов даются ниже, после списка группы. Реферат должен быть написан в формате А4; шрифтом Times New Roman размером 14 пунктов; межстрочный интервал – одинарный; поля – верхнее 20, левое – 30, нижнее – 20, правое – 15 мм. Абзацы в тексте начинают отступом 1,25 см. Приучайтесь, такие правила в оформлении дипломной работы.
Требования к реферату следующие:
1. Раскрыть тему реферата.
2. Объем реферата – 5 страниц. Больше или меньше этого объема нельзя!
3. Он должен быть логически последовательно изложен, а не представлять набор не связанных между собой разрозненных частей.
	Написанный реферат нужно отправить до 1 марта 2021 г. на мою электронную почту: olehnovich@bsuir.by. Жду рефератов.
	После 8 марта, если занятия возобновятся, то будем лекции и семинары проводить согласно расписанию. Часть лекций, которые я вам не успею прочесть из-за карантина, вышлю по электронной почте. Если после 8 марта карантин продолжится – будем думать дальше. 
	Ваш Олехнович Е.А.

Антоник	1
Борисюк	2
Быковская	3
Вутто	4
Гарр	5
Губко	6
Дашкевич	7
Ефимов	8
Каролинский	9
Картовицкая	10
Корсунов	11
Краснова	12
Кучеренко	13
Ли	14
Мартинович	15
Мороз	16
Науёкас	17
Никитко	18
Пашкевич	19
Саяркин	20
Седнёв	21
Селицкая	22
Синькевич	23
Сорока	24
Струневская	25
Шилов	26
Шлапакова	27
Юшкевич	28


1.	Основные функции и структура рынка.
2.	Денежные доходы населения и источники их формирования
3.	Социальная политика государства.
4.	Уровень жизни и определяющие его факторы.
5.	Инвестиции. Их роль и источники формирования.
6.	Инновационная деятельность.
7.	Роль государства в условиях рыночной экономики.
8.	Организация денежного обращения в стране.
9.	Типы и формы собственности.
10.	 Определение чистой монополии. Антимонопольное законодательство.
11.	 Роль государства в рыночной экономике.
12.	 Рынок труда. Спрос и предложение на рынке труда.
13.	 Национальное богатство и его структура.
14.	 Современная валютная система.
15.	 Международная миграция рабочей силы
16.	 Денежная система Вьетнама
17.	 Внешняя торговля Вьетнама.
18.	 Социально-экономические последствия инфляционных процессов.
19.	 Что такое свободные экономические зоны и для чего они нужны?
20.	 Предпринимательская деятельность. Формы и виды.
21.	 Основные виды ценных бумаг.
22.	 Бизнес-план и его структура.
23.	 Коммерческие банки и их роль в рыночной экономике.
24.	 Налоговая система и принципы ее функционирования.
25.	 Сущность лизинга и его основные виды.
26.	 Деятельность Международного валютного фонда.
27.	 Информационные технологии в экономике.
28.	 Общественные блага и их виды.
29.	 Понятие и показатели эффективности производства.
30.	 Деятельность Всемирной торговой организации.

